Welcome to TerraOS

_________  _______   ________  ________  ________     
|\___   ___\\  ___ \ |\   __  \|\   __  \|\   __  \    
\|___ \  \_\ \   __/|\ \  \|\  \ \  \|\  \ \  \|\  \   
     \ \  \ \ \  \_|/_\ \   _  _\ \   _  _\ \   __  \  
      \ \  \ \ \  \_|\ \ \  \\  \\ \  \\  \\ \  \ \  \ 
       \ \__\ \ \_______\ \__\\ _\\ \__\\ _\\ \__\ \__\
        \|__|  \|_______|\|__|\|__|\|__|\|__|\|__|\|__|

